cl	cl
a	a
i	i
u	u
e	e
o	o
ka	k a
ki	k i
ku	k u
ke	k e
ko	k o
sa	s a
shi	sh i
su	s u
se	s e
so	s o
ta	t a
ti	ch i
chi	ch i
tsu	ts u
te	t e
to	t o
na	n a
ni	n i
nu	n u
ne	n e
no	n o
ha	h a
hi	h i
hu	f u
fu	f u
he	h e
ho	h o
ma	m a
mi	m i
mu	m u
me	m e
mo	m o
ya	y a
yi	i
yu	y u
yo	y o
ra	r a
ri	r i
ru	r u
re	r e
ro	r o
wa	w a
wo	w o
n	N
ga	g a
gi	g i
gu	g u
ge	g e
go	g o
za	z a
zi	j i
ji	j i
zu	z u
ze	z e
zo	z o
da	d a
di	d i
du	d u
de	d e
do	d o
ba	b a
bi	b i
bu	b u
be	b e
bo	b o
pa	p a
pi	p i
pu	p u
pe	p e
po	p o
kya	ky a
kyu	ky u
kyo	ky o
gya	gy a
gyu	gy u
gyo	gy o
sha	sh a
shu	sh u
sho	sh o
ja	j a
ju	j u
jo	j o
cha	ch a
chu	ch u
cho	ch o
nya	ny a
nyu	ny u
nyo	ny o
hya	hy a
hyu	hy u
hyo	hy o
bya	by a
byu	by u
byo	by o
pya	py a
pyu	py u
pyo	py o
mya	my a
myu	my u
myo	my o
rya	ry a
ryu	ry u
ryo	ry o
tya	ty a
tyu	ty u
tyo	ty o
dya	dy a
dyu	dy u
dyo	dy o
